W W W W W W W W W W W W 

W W W W W W W W W W W W 

W W W P W W M W W W W W 

W W W P W W T W W P W W 

W W W P W W P P P P W W 

W W W P W W P W W W W W 

W W W P W W P W W W W W 

W W P P P P P P P P W W 

W W P W W W W P W W W W 

W W P W W W W P P P P W 

W W P W W W W W W W W W 

W W D W W W W W W W W W 

Ep 13